0000000000022222222
0000000000020044442
2222222222220044442
2000020030300044442
2033323003020044442
2003000003020044442
2033023030322222222
2003020000020000000
2202222222220000000
2000020000220000000
2000003000220000000
2003323300120000000
2000020000220000000
2222222222200000000