222222222000000
200000002000000
200000002222000
220222202002000
220212200002000
203330300332000
200202203002000
200202200302222
222200333032002
020002200044442
020200020244042
020002020224442
022222030024442
000002200022222
000000222220000