0022220000000000
0020022222222222
0020000300030302
0020320302003002
0020030300200002
2220320200222202
2123030300220002
2000030232000202
2000300003030302
0222200222222222
0020000002000000
0020000002000000
0024444442000000
0024444442000000
0024444442000000
0022222222000000