00000000222222220
00000000200000120
00000000203230220
00000000203003200
00000000223030200
22222222203020222
24444002203003002
22444000030030002
24444002222222222
22222222000000000