00000000222220000
00000000200022222
00000000202322002
00000000200000302
22222222202220002
24444002203003222
24444000030330220
24444002230030120
22222222200300220
00000000203030020
00000000222022020
00000000002000020
00000000002222220