22222222222200
24400200000222
24400203003002
24400232222002
24400001022002
24400202003022
22222202230302
00203003030302
00200002000002
00222222222222