00000000002222222
00000000002004442
00000022222004442
00000020000004042
00000020022004442
00000022022004442
00000222022222222
00000203330220000
02222200303022222
22000230300020002
21030030000300302
22222203303022222
00000200000020000
00000222222220000