0000000222220
0222222200022
2202012203302
2000030000002
2003002220002
2220222223222
2030022204420
2030303044420
2000022244420
2033020244420
2002220222220
2222000000000
