22222222
21000002
20003002
20030342
20303042
20030342
20044442
22222222