222222002220
244002022122
244002220002
244000003302
244002020302
244222020302
222203023002
000200320302
000203003002
000200220002
000222222222